--------    -------         
|......|  ##+.....|   ##### 
|.@....|  # |.....|   #   # 
|......+### |.....+####   # 
|......|    |.....|       # 
|......| ###+.....|       # 
|....F.| #  ----+--   ##### 
----+--- #      #     #     
    #    #      #   --+---  
    #    #      #   |....|  
    #############   |...=|  
                    ------  