--------    -------         
|......|  ##+.....|   ##### 
|......|  # |.....|   #   # 
|......+### |.....+####   # 
|......|    |.....|       # 
|......| ###+.....|       # 
|......| #  ----+--   ##### 
----+--- #      #     #     
    #    #      #   --+---  
    #    #      #   |....|  
    #############   |...=|  
                    ------  